WWWWWWWWWWWWWWW
WP....W..W....W
WWW.W...W.....W
W.....W.......W
W...W....W....W
W...W....W....W
W...W....W....W
W...W....W....W
W...W....W....W
W...W....W....W
W...W....W....W
W...W....W....W
W...W....WWW..W
W...W....W..WGW
WWWWWWWWWWWWWWW