WWWWWWWWWWWWWWW
WP....W..W....W
WWW.W...W..W..W
W.....W....W..W
W...W...W.....W
W...W....W....W
W.....WW.W....W
W.WWW......W..W
W...W....W....W
WW..W....WWWWWW
W.....W..W....W
W.W.W..W....W.W
W...W....W....W
W...W....W....W
WWWWWWWWWWWWWGW